********************
*                  *
*  *********       *
*  *       *       *
*  * ****** ****** *
*  * *             *
*  * * ***** ** ***
*  * *    *  * *  *
*  * ***** ** *** *
*  *             * *
*  ********** *** *
*          *     * *
* ********** *** * *
* *        *     * *
* * ********* *** * *
* * *            * *
* * * ********** * *
* * * *        * * *
* * * * ******* * * *
* 0              ***
********************