**                                                           
** ***** ******* * ******* *** * *********** ***** *** *** * 
 *     * *       *   * *     * * * *       * *   * *   *   * 
 *** * * *** * *** * * *** ******* * *********** ***** ***** 
 * * * * *   * *   *   *       *     * *       * * *       * 
 * * * *** *** ******************* *** * * ***** * *** ***** 
   * * *     *   *   *       *           *   *             * 
 ******* * * * *** *** * * * ******* ***** * * * * *** ***** 
 *   * * * * *   *   * * * *       * *     *   * *   *   *   
 *** * *** ******* *** ***** ********* ***** ***** *** *** * 
     * * *     * *       *   *       * *   * * *   * *   * * 
 ***** * *** *** ***** * ******* * * * * *** * * * * * ***** 
 *         *   *   *   *         * * *   *   *   *   * *     
 ******* ******* *** * ******* ***** *************** ***** * 
       * *   * *     * *       *     * * *         * * *   * 
 *** *** * *** ***** ******* * * ***** * *** * ******* *** * 
 *           *     *   *   * * *     *   *   *   *   *   * * 
 *** *** ******* *** * *** * ******* *** *** ******* * *** * 
 *     *         *   * *     * *   * * *     *   * *     * * 
 *** *** ********* * *** ***** * * *** * * * *** * *** ***** 
 * * *     *       * *       *   * * *   * * *       * *   * 
 * * * * * * ******* * *** * * *** * *** ********* * * *** * 
 *   * * * * *   *   *   * * *   * * *   *     * * * *       
 ******* ***** ************* * ***** * *** ***** * ********* 
 *       *     *         *                 * *   *           
 * * ******* ********* *** * * ***** ******* *** * *** * *** 
 * *   * *     * * *       * *   * *             * * * *   * 
 * *** * ***** * * ************* * *** * * *** ***** ******* 
 * * *   *   *     *     *           * * *   * * *         * 
 *** * * *** *** ******* * ***** * *** *** ***** * *** *** * 
     * * *     *   *       *   * * * * *         *   *   * * 
 * ***** * * *** *** *** * * ***** * ********* * * ********* 
 * *   *   *   *   * * * *   *   *   *     * * *       * *   
 ***** *** ***** * *** ***** *** ******* * * * ********* *** 
 * *   *   *     *   * *   *   *   *     *     *             
 * *** ***** ***** *** *** ******* *** ******* * *********** 
 *   *   *   * *     *   * * * *   * *     *           *   * 
 * * *** *** * ***** *** * * * * * * * ***** *** ******* *** 
 * *       * *   *     *   *     *   *   *   * * *     *   * 
 * ***** *** * *** ***** * *** *** *** * ***** *** * *** * * 
 * * *   *   *           *   * * * *   * *     *   *     * * 
 * * * ***** *** *************** * * *** * ******* * ******* 
 *   *         *         *         * *   * *   * * *       * 
 ******* * ***** *** ******* ************* *** * * ********* 
     *   *   *   * * *     *             *             *   * 
 ***** ***** * *** ******* * ***** *** *** ***** ***** *** * 
 *   * *     * * *   *   * *   *     * * * * * *     * * *   
 *** ***** ***** * *** * * * *********** * * * * ***** * *** 
 *           * *       *         *   *   *     *   * * * *   
 * * ********* *** *** * * * ******* *** * ***** * * *** *** 
   * *   * *     * *   * * *       *     * *   * * * *       
 ******* * * ***** *** ***** * * *** * *** * ******* * ***** 
   * * * *           *     * * * *   * * *             *     
 * * * * * ********* ******* ***** ***** * ******* *** ***** 
 * *     * *   * *   *   * * *   *       *       *   * *   * 
 ******* * * *** * * * *** ***** ******* * *** * * ***** *** 
 *         *     * *     *       *   *       * * * *   * *   
 ******* * ***** *** * * * ********* * ***** * * *** *** * * 
     * * * * *   * * * * *     * * *   * *   * * *   *   * **
 ***** ***** * *** * ******* *** * ***** ********* *** ******
                                                            0
