****0 ******** * * * ****** ******** * * * *
*     *   *    *** *** *  *     *  * *** * *
**** ** ******** *** * *  ****  **** *   ***
  *  *       *     *        *   *    *****  
**************  ****        *   *    *   ***
   *        *    *     *  * *  *******   *  
**** * * *  ******  ****  * *  * *       *  
   * *****    *      *    ***  ***       *  
   *     *    *      *      ****        **  
****    **   *********       *          *   
   ******            *********   ********   
       *  *********  *           *          
       ****       ****         **********   
     ***            *            *    *     
****** **************  *********************